11111111111111111111
1P0E0C111111111CC101
100000000000000CC1C1
11111111111111CCC101
111111111111111111C1
11111111111111111111